{
"BackCround":{
"backCround_type":1,"bottom_type":2,"skill_type":0},"level":110,"mode":1,"LevelType":{
"Key":"@","Type":1,"Number":5},"Star":{
"star1":1000,"star2":5630,"star3":10010},"Gang":{
"Gang1":0,"Gang2":1,"Gang3":0,"Gang4":0,"Gang5":0},"ReadyBubble":{
"R1":0,"R2":0,"R3":0,"R4":0},"BallNumber":25,"TimeLimit":0,"ObjChance":[{
"Key":"C","P":5},{
"Key":"A","P":5},{
"Key":"B","P":5},{
"Key":"D","P":5}],"top":[],"bubble
":[{
"key":"I","x":0,"y":0,"s":1,"i":0},{
"key":"C","x":0,"y":1,"s":1,"i":0},{
"key":"CJ","x":0,"y":2,"s":1,"i":0},{
"key":"@","x":0,"y":3,"s":1,"i":0},{
"key":"@","x":0,"y":4,"s":1,"i":0},{
"key":"DJ","x":0,"y":5,"s":1,"i":0},{
"key":"D","x":0,"y":6,"s":1,"i":0},{
"key":"F","x":0,"y":7,"s":1,"i":0},{
"key":"BJ","x":0,"y":8,"s":1,"i":0},{
"key":"@","x":0,"y":9,"s":1,"i":0},{
"key":"I","x":0,"y":10,"s":1,"i":0},{
"key":"I","x":1,"y":0,"s":1,"i":0},{
"key":"A","x":1,"y":1,"s":1,"i":0},{
"key":"@","x":1,"y":2,"s":1,"i":0},{
"key":"A","x":1,"y":3,"s":1,"i":0},{
"key":"@","x":1,"y":4,"s":1,"i":0},{
"key":"D","x":1,"y":5,"s":1,"i":0},{
"key":"F","x":1,"y":6,"s":1,"i":0},{
"key":"B","x":1,"y":7,"s":1,"i":0},{
"key":"@","x":1,"y":8,"s":1,"i":0},{
"key":"@","x":1,"y":9,"s":1,"i":0},{
"key":"I","x":2,"y":0,"s":1,"i":0},{
"key":"A","x":2,"y":1,"s":1,"i":0},{
"key":"B","x":2,"y":2,"s":1,"i":0},{
"key":"L","x":2,"y":3,"s":1,"i":0},{
"key":"A","x":2,"y":4,"s":1,"i":0},{
"key":"A","x":2,"y":5,"s":1,"i":0},{
"key":"F","x":2,"y":6,"s":1,"i":0},{
"key":"D","x":2,"y":7,"s":1,"i":0},{
"key":"K","x":2,"y":8,"s":1,"i":0},{
"key":"B","x":2,"y":9,"s":1,"i":0},{
"key":"I","x":2,"y":10,"s":1,"i":0},{
"key":"I","x":3,"y":0,"s":1,"i":0},{
"key":"D","x":3,"y":1,"s":1,"i":0},{
"key":"D","x":3,"y":2,"s":1,"i":0},{
"key":"B","x":3,"y":3,"s":1,"i":0},{
"key":"B","x":3,"y":4,"s":1,"i":0},{
"key":"F","x":3,"y":5,"s":1,"i":0},{
"key":"D","x":3,"y":6,"s":1,"i":0},{
"key":"K","x":3,"y":7,"s":1,"i":0},{
"key":"A","x":3,"y":8,"s":1,"i":0},{
"key":"I","x":3,"y":9,"s":1,"i":0},{
"key":"I","x":4,"y":0,"s":1,"i":0},{
"key":"B","x":4,"y":1,"s":1,"i":0},{
"key":"B","x":4,"y":2,"s":1,"i":0},{
"key":"C","x":4,"y":3,"s":1,"i":0},{
"key":"B","x":4,"y":4,"s":1,"i":0},{
"key":"F","x":4,"y":5,"s":1,"i":0},{
"key":"A","x":4,"y":6,"s":1,"i":0},{
"key":"B","x":4,"y":7,"s":1,"i":0},{
"key":"K","x":4,"y":8,"s":1,"i":0},{
"key":"A","x":4,"y":9,"s":1,"i":0},{
"key":"I","x":4,"y":10,"s":1,"i":0},{
"key":"I","x":5,"y":0,"s":1,"i":0},{
"key":"A","x":5,"y":1,"s":1,"i":0},{
"key":"C","x":5,"y":2,"s":1,"i":0},{
"key":"CJ","x":5,"y":3,"s":1,"i":0},{
"key":"F","x":5,"y":4,"s":1,"i":0},{
"key":"F","x":5,"y":5,"s":1,"i":0},{
"key":"A","x":5,"y":6,"s":1,"i":0},{
"key":"BJ","x":5,"y":7,"s":1,"i":0},{
"key":"D","x":5,"y":8,"s":1,"i":0},{
"key":"I","x":5,"y":9,"s":1,"i":0},{
"key":"I","x":6,"y":0,"s":1,"i":0},{
"key":"A","x":6,"y":1,"s":1,"i":0},{
"key":"K","x":6,"y":2,"s":1,"i":0},{
"key":"@","x":6,"y":3,"s":1,"i":0},{
"key":"D","x":6,"y":4,"s":1,"i":0},{
"key":"F","x":6,"y":5,"s":1,"i":0},{
"key":"C","x":6,"y":6,"s":1,"i":0},{
"key":"C","x":6,"y":7,"s":1,"i":0},{
"key":"D","x":6,"y":8,"s":1,"i":0},{
"key":"D","x":6,"y":9,"s":1,"i":0},{
"key":"I","x":6,"y":10,"s":1,"i":0},{
"key":"I","x":7,"y":0,"s":1,"i":0},{
"key":"A","x":7,"y":1,"s":1,"i":0},{
"key":"K","x":7,"y":2,"s":1,"i":0},{
"key":"@","x":7,"y":3,"s":1,"i":0},{
"key":"F","x":7,"y":4,"s":1,"i":0},{
"key":"@","x":7,"y":5,"s":1,"i":0},{
"key":"A","x":7,"y":6,"s":1,"i":0},{
"key":"A","x":7,"y":7,"s":1,"i":0},{
"key":"D","x":7,"y":8,"s":1,"i":0},{
"key":"I","x":7,"y":9,"s":1,"i":0},{
"key":"I","x":8,"y":0,"s":1,"i":0},{
"key":"C","x":8,"y":1,"s":1,"i":0},{
"key":"K","x":8,"y":2,"s":1,"i":0},{
"key":"D","x":8,"y":3,"s":1,"i":0},{
"key":"F","x":8,"y":4,"s":1,"i":0},{
"key":"B","x":8,"y":5,"s":1,"i":0},{
"key":"D","x":8,"y":6,"s":1,"i":0},{
"key":"L","x":8,"y":7,"s":1,"i":0},{
"key":"A","x":8,"y":8,"s":1,"i":0},{
"key":"C","x":8,"y":9,"s":1,"i":0},{
"key":"I","x":8,"y":10,"s":1,"i":0},{
"key":"I","x":9,"y":0,"s":1,"i":0},{
"key":"C","x":9,"y":1,"s":1,"i":0},{
"key":"A","x":9,"y":2,"s":1,"i":0},{
"key":"F","x":9,"y":3,"s":1,"i":0},{
"key":"B","x":9,"y":4,"s":1,"i":0},{
"key":"B","x":9,"y":5,"s":1,"i":0},{
"key":"D","x":9,"y":6,"s":1,"i":0},{
"key":"B","x":9,"y":7,"s":1,"i":0},{
"key":"C","x":9,"y":8,"s":1,"i":0},{
"key":"I","x":9,"y":9,"s":1,"i":0},{
"key":"I","x":10,"y":0,"s":1,"i":0},{
"key":"C","x":10,"y":1,"s":1,"i":0},{
"key":"A","x":10,"y":2,"s":1,"i":0},{
"key":"F","x":10,"y":3,"s":1,"i":0},{
"key":"A","x":10,"y":4,"s":1,"i":0},{
"key":"A","x":10,"y":5,"s":1,"i":0},{
"key":"D","x":10,"y":6,"s":1,"i":0},{
"key":"D","x":10,"y":7,"s":1,"i":0},{
"key":"B","x":10,"y":8,"s":1,"i":0},{
"key":"C","x":10,"y":9,"s":1,"i":0},{
"key":"I","x":10,"y":10,"s":1,"i":0}],"sub
":[],"down
":[],"jysub

":[]}