{
"BackCround":{
"backCround_type":1,"bottom_type":2,"skill_type":0},"level":231,"mode":1,"LevelType":{
"Key":"@","Type":1,"Number":10},"Star":{
"star1":2000,"star2":23450,"star3":50695},"Gang":{
"Gang1":0,"Gang2":1,"Gang3":0,"Gang4":0,"Gang5":1},"ReadyBubble":{
"R1":0,"R2":0,"R3":0,"R4":0},"BallNumber":33,"TimeLimit":0,"ObjChance":[{
"Key":"C","P":5},{
"Key":"A","P":5},{
"Key":"B","P":5},{
"Key":"D","P":5}],"top":[],"bubble
":[{
"key":"I","x":0,"y":2,"s":1,"i":0},{
"key":"BJ","x":0,"y":3,"s":1,"i":0},{
"key":"CJ","x":0,"y":4,"s":1,"i":0},{
"key":"CJ","x":0,"y":5,"s":1,"i":0},{
"key":"AJ","x":0,"y":6,"s":1,"i":0},{
"key":"AJ","x":0,"y":7,"s":1,"i":0},{
"key":"I","x":0,"y":8,"s":1,"i":0},{
"key":"I","x":1,"y":2,"s":1,"i":0},{
"key":"BJ","x":1,"y":3,"s":1,"i":0},{
"key":"CJ","x":1,"y":4,"s":1,"i":0},{
"key":"DJ","x":1,"y":5,"s":1,"i":0},{
"key":"I","x":1,"y":7,"s":1,"i":0},{
"key":"I","x":2,"y":3,"s":1,"i":0},{
"key":"DJ","x":2,"y":5,"s":1,"i":0},{
"key":"DJ","x":2,"y":6,"s":1,"i":0},{
"key":"I","x":2,"y":7,"s":1,"i":0},{
"key":"I","x":3,"y":3,"s":1,"i":0},{
"key":"A","x":3,"y":4,"s":1,"i":0},{
"key":"A","x":3,"y":5,"s":1,"i":0},{
"key":"I","x":3,"y":6,"s":1,"i":0},{
"key":"I","x":4,"y":4,"s":1,"i":0},{
"key":"@","x":4,"y":5,"s":1,"i":0},{
"key":"I","x":4,"y":6,"s":1,"i":0},{
"key":"I","x":5,"y":0,"s":1,"i":0},{
"key":"I","x":5,"y":1,"s":1,"i":0},{
"key":"I","x":5,"y":2,"s":1,"i":0},{
"key":"I","x":5,"y":3,"s":1,"i":0},{
"key":"@","x":5,"y":4,"s":1,"i":0},{
"key":"@","x":5,"y":5,"s":1,"i":0},{
"key":"I","x":5,"y":6,"s":1,"i":0},{
"key":"I","x":5,"y":7,"s":1,"i":0},{
"key":"I","x":5,"y":8,"s":1,"i":0},{
"key":"I","x":5,"y":9,"s":1,"i":0},{
"key":"D","x":6,"y":0,"s":1,"i":0},{
"key":"D","x":6,"y":1,"s":1,"i":0},{
"key":"C","x":6,"y":2,"s":1,"i":0},{
"key":"F","x":6,"y":3,"s":1,"i":0},{
"key":"@","x":6,"y":4,"s":1,"i":0},{
"key":"@","x":6,"y":5,"s":1,"i":0},{
"key":"@","x":6,"y":6,"s":1,"i":0},{
"key":"F","x":6,"y":7,"s":1,"i":0},{
"key":"A","x":6,"y":9,"s":1,"i":0},{
"key":"D","x":7,"y":1,"s":1,"i":0},{
"key":"C","x":7,"y":2,"s":1,"i":0},{
"key":"F","x":7,"y":3,"s":1,"i":0},{
"key":"F","x":7,"y":4,"s":1,"i":0},{
"key":"F","x":7,"y":5,"s":1,"i":0},{
"key":"F","x":7,"y":6,"s":1,"i":0},{
"key":"B","x":7,"y":7,"s":1,"i":0},{
"key":"A","x":7,"y":9,"s":1,"i":0},{
"key":"B","x":8,"y":0,"s":1,"i":0},{
"key":"@","x":8,"y":1,"s":1,"i":0},{
"key":"@","x":8,"y":2,"s":1,"i":0},{
"key":"A","x":8,"y":6,"s":1,"i":0},{
"key":"@","x":8,"y":7,"s":1,"i":0},{
"key":"A","x":8,"y":8,"s":1,"i":0},{
"key":"I","x":8,"y":9,"s":1,"i":0},{
"key":"B","x":9,"y":0,"s":1,"i":0},{
"key":"K","x":9,"y":1,"s":1,"i":0},{
"key":"@","x":9,"y":2,"s":1,"i":0},{
"key":"@","x":9,"y":6,"s":1,"i":0},{
"key":"@","x":9,"y":7,"s":1,"i":0},{
"key":"I","x":9,"y":8,"s":1,"i":0},{
"key":"A","x":9,"y":9,"s":1,"i":0},{
"key":"B","x":10,"y":0,"s":1,"i":0},{
"key":"K","x":10,"y":1,"s":1,"i":0},{
"key":"A","x":10,"y":2,"s":1,"i":0},{
"key":"A","x":10,"y":3,"s":1,"i":0},{
"key":"K","x":10,"y":4,"s":1,"i":0},{
"key":"D","x":10,"y":5,"s":1,"i":0},{
"key":"D","x":10,"y":6,"s":1,"i":0},{
"key":"A","x":10,"y":7,"s":1,"i":0},{
"key":"I","x":10,"y":8,"s":1,"i":0},{
"key":"A","x":10,"y":9,"s":1,"i":0},{
"key":"A","x":10,"y":10,"s":1,"i":0},{
"key":"K","x":11,"y":1,"s":1,"i":0},{
"key":"C","x":11,"y":2,"s":1,"i":0},{
"key":"K","x":11,"y":3,"s":1,"i":0},{
"key":"A","x":11,"y":4,"s":1,"i":0},{
"key":"A","x":11,"y":5,"s":1,"i":0},{
"key":"D","x":11,"y":6,"s":1,"i":0},{
"key":"I","x":11,"y":7,"s":1,"i":0},{
"key":"A","x":11,"y":8,"s":1,"i":0},{
"key":"A","x":11,"y":9,"s":1,"i":0},{
"key":"C","x":12,"y":0,"s":1,"i":0},{
"key":"C","x":12,"y":2,"s":1,"i":0},{
"key":"K","x":12,"y":3,"s":1,"i":0},{
"key":"A","x":12,"y":4,"s":1,"i":0},{
"key":"A","x":12,"y":5,"s":1,"i":0},{
"key":"G","x":12,"y":6,"s":1,"i":0},{
"key":"B","x":12,"y":7,"s":1,"i":0},{
"key":"I","x":12,"y":8,"s":1,"i":0},{
"key":"I","x":12,"y":9,"s":1,"i":0},{
"key":"I","x":12,"y":10,"s":1,"i":0},{
"key":"C","x":13,"y":0,"s":1,"i":0},{
"key":"B","x":13,"y":2,"s":1,"i":0},{
"key":"B","x":13,"y":3,"s":1,"i":0},{
"key":"G","x":13,"y":4,"s":1,"i":0},{
"key":"G","x":13,"y":5,"s":1,"i":0},{
"key":"B","x":13,"y":6,"s":1,"i":0},{
"key":"B","x":13,"y":7,"s":1,"i":0},{
"key":"B","x":13,"y":8,"s":1,"i":0},{
"key":"C","x":14,"y":0,"s":1,"i":0},{
"key":"A","x":14,"y":1,"s":1,"i":0},{
"key":"A","x":14,"y":2,"s":1,"i":0},{
"key":"K","x":14,"y":3,"s":1,"i":0},{
"key":"@","x":14,"y":4,"s":1,"i":0},{
"key":"G","x":14,"y":5,"s":1,"i":0},{
"key":"C","x":14,"y":6,"s":1,"i":0},{
"key":"C","x":14,"y":7,"s":1,"i":0},{
"key":"A","x":14,"y":8,"s":1,"i":0},{
"key":"C","x":14,"y":10,"s":1,"i":0},{
"key":"K","x":15,"y":2,"s":1,"i":0},{
"key":"@","x":15,"y":3,"s":1,"i":0},{
"key":"@","x":15,"y":4,"s":1,"i":0},{
"key":"G","x":15,"y":5,"s":1,"i":0},{
"key":"C","x":15,"y":6,"s":1,"i":0},{
"key":"A","x":15,"y":7,"s":1,"i":0},{
"key":"C","x":15,"y":9,"s":1,"i":0},{
"key":"I","x":16,"y":0,"s":1,"i":0},{
"key":"I","x":16,"y":1,"s":1,"i":0},{
"key":"I","x":16,"y":2,"s":1,"i":0},{
"key":"K","x":16,"y":3,"s":1,"i":0},{
"key":"D","x":16,"y":4,"s":1,"i":0},{
"key":"G","x":16,"y":5,"s":1,"i":0},{
"key":"G","x":16,"y":6,"s":1,"i":0},{
"key":"G","x":16,"y":7,"s":1,"i":0},{
"key":"D","x":16,"y":8,"s":1,"i":0},{
"key":"@","x":16,"y":9,"s":1,"i":0},{
"key":"C","x":17,"y":1,"s":1,"i":0},{
"key":"I","x":17,"y":2,"s":1,"i":0},{
"key":"D","x":17,"y":3,"s":1,"i":0},{
"key":"F","x":17,"y":4,"s":1,"i":0},{
"key":"F","x":17,"y":5,"s":1,"i":0},{
"key":"G","x":17,"y":6,"s":1,"i":0},{
"key":"G","x":17,"y":7,"s":1,"i":0},{
"key":"@","x":17,"y":8,"s":1,"i":0},{
"key":"C","x":18,"y":0,"s":1,"i":0},{
"key":"C","x":18,"y":1,"s":1,"i":0},{
"key":"I","x":18,"y":3,"s":1,"i":0},{
"key":"F","x":18,"y":4,"s":1,"i":0},{
"key":"F","x":18,"y":5,"s":1,"i":0},{
"key":"F","x":18,"y":6,"s":1,"i":0},{
"key":"G","x":18,"y":7,"s":1,"i":0},{
"key":"D","x":18,"y":8,"s":1,"i":0},{
"key":"@","x":19,"y":0,"s":1,"i":0},{
"key":"@","x":19,"y":1,"s":1,"i":0},{
"key":"I","x":19,"y":3,"s":1,"i":0},{
"key":"A","x":19,"y":4,"s":1,"i":0},{
"key":"@","x":19,"y":5,"s":1,"i":0},{
"key":"@","x":19,"y":6,"s":1,"i":0},{
"key":"G","x":19,"y":7,"s":1,"i":0},{
"key":"A","x":19,"y":8,"s":1,"i":0},{
"key":"A","x":19,"y":9,"s":1,"i":0},{
"key":"A","x":20,"y":0,"s":1,"i":0},{
"key":"B","x":20,"y":1,"s":1,"i":0},{
"key":"@","x":20,"y":2,"s":1,"i":0},{
"key":"B","x":20,"y":3,"s":1,"i":0},{
"key":"I","x":20,"y":4,"s":1,"i":0},{
"key":"G","x":20,"y":5,"s":1,"i":0},{
"key":"@","x":20,"y":6,"s":1,"i":0},{
"key":"D","x":20,"y":7,"s":1,"i":0},{
"key":"D","x":20,"y":8,"s":1,"i":0},{
"key":"A","x":20,"y":9,"s":1,"i":0},{
"key":"I","x":21,"y":1,"s":1,"i":0},{
"key":"I","x":21,"y":2,"s":1,"i":0},{
"key":"I","x":21,"y":3,"s":1,"i":0},{
"key":"G","x":21,"y":4,"s":1,"i":0},{
"key":"G","x":21,"y":5,"s":1,"i":0},{
"key":"G","x":21,"y":6,"s":1,"i":0},{
"key":"I","x":21,"y":7,"s":1,"i":0},{
"key":"I","x":21,"y":8,"s":1,"i":0},{
"key":"I","x":21,"y":9,"s":1,"i":0},{
"key":"B","x":22,"y":0,"s":1,"i":0},{
"key":"A","x":22,"y":2,"s":1,"i":0},{
"key":"C","x":22,"y":4,"s":1,"i":0},{
"key":"C","x":22,"y":5,"s":1,"i":0},{
"key":"C","x":22,"y":6,"s":1,"i":0},{
"key":"I","x":22,"y":7,"s":1,"i":0},{
"key":"A","x":22,"y":8,"s":1,"i":0},{
"key":"B","x":22,"y":9,"s":1,"i":0},{
"key":"B","x":22,"y":10,"s":1,"i":0},{
"key":"B","x":23,"y":0,"s":1,"i":0},{
"key":"D","x":23,"y":2,"s":1,"i":0},{
"key":"I","x":23,"y":7,"s":1,"i":0},{
"key":"A","x":23,"y":8,"s":1,"i":0},{
"key":"B","x":23,"y":9,"s":1,"i":0},{
"key":"B","x":24,"y":0,"s":1,"i":0},{
"key":"A","x":24,"y":1,"s":1,"i":0},{
"key":"D","x":24,"y":2,"s":1,"i":0},{
"key":"A","x":24,"y":3,"s":1,"i":0},{
"key":"@","x":24,"y":4,"s":1,"i":0},{
"key":"@","x":24,"y":5,"s":1,"i":0},{
"key":"B","x":24,"y":6,"s":1,"i":0},{
"key":"B","x":24,"y":7,"s":1,"i":0},{
"key":"I","x":24,"y":8,"s":1,"i":0},{
"key":"A","x":24,"y":9,"s":1,"i":0},{
"key":"A","x":25,"y":0,"s":1,"i":0},{
"key":"@","x":25,"y":1,"s":1,"i":0},{
"key":"A","x":25,"y":2,"s":1,"i":0},{
"key":"A","x":25,"y":4,"s":1,"i":0},{
"key":"C","x":25,"y":7,"s":1,"i":0},{
"key":"I","x":25,"y":8,"s":1,"i":0},{
"key":"D","x":26,"y":0,"s":1,"i":0},{
"key":"@","x":26,"y":2,"s":1,"i":0},{
"key":"D","x":26,"y":5,"s":1,"i":0},{
"key":"C","x":26,"y":8,"s":1,"i":0},{
"key":"A","x":26,"y":10,"s":1,"i":0},{
"key":"D","x":27,"y":0,"s":1,"i":0},{
"key":"@","x":27,"y":1,"s":1,"i":0},{
"key":"C","x":27,"y":2,"s":1,"i":0},{
"key":"C","x":27,"y":3,"s":1,"i":0},{
"key":"D","x":27,"y":4,"s":1,"i":0},{
"key":"D","x":27,"y":5,"s":1,"i":0},{
"key":"@","x":27,"y":7,"s":1,"i":0},{
"key":"@","x":27,"y":8,"s":1,"i":0},{
"key":"A","x":27,"y":9,"s":1,"i":0}],"sub
":[],"down
":[],"jysub

":[]}