{
"BackCround":{
"backCround_type":1,"bottom_type":2,"skill_type":0},"level":101,"mode":1,"LevelType":{
"Key":"@","Type":1,"Number":5},"Star":{
"star1":2000,"star2":13000,"star3":25000},"Gang":{
"Gang1":0,"Gang2":1,"Gang3":0,"Gang4":0,"Gang5":0},"ReadyBubble":{
"R1":3,"R2":1,"R3":0,"R4":0},"BallNumber":26,"TimeLimit":0,"ObjChance":[{
"Key":"C","P":3},{
"Key":"A","P":3},{
"Key":"B","P":3}],"top":[],"bubble
":[{
"key":"B","x":0,"y":0,"s":1,"i":0},{
"key":"B","x":0,"y":1,"s":1,"i":0},{
"key":"K","x":0,"y":2,"s":1,"i":0},{
"key":"AJ","x":0,"y":3,"s":1,"i":0},{
"key":"A","x":0,"y":4,"s":1,"i":0},{
"key":"B","x":0,"y":5,"s":1,"i":0},{
"key":"A","x":0,"y":6,"s":1,"i":0},{
"key":"AJ","x":0,"y":7,"s":1,"i":0},{
"key":"K","x":0,"y":8,"s":1,"i":0},{
"key":"C","x":0,"y":9,"s":1,"i":0},{
"key":"C","x":0,"y":10,"s":1,"i":0},{
"key":"B","x":1,"y":0,"s":1,"i":0},{
"key":"B","x":1,"y":1,"s":1,"i":0},{
"key":"K","x":1,"y":2,"s":1,"i":0},{
"key":"A","x":1,"y":3,"s":1,"i":0},{
"key":"B","x":1,"y":4,"s":1,"i":0},{
"key":"B","x":1,"y":5,"s":1,"i":0},{
"key":"A","x":1,"y":6,"s":1,"i":0},{
"key":"K","x":1,"y":7,"s":1,"i":0},{
"key":"C","x":1,"y":8,"s":1,"i":0},{
"key":"C","x":1,"y":9,"s":1,"i":0},{
"key":"K","x":2,"y":0,"s":1,"i":0},{
"key":"K","x":2,"y":1,"s":1,"i":0},{
"key":"A","x":2,"y":2,"s":1,"i":0},{
"key":"K","x":2,"y":3,"s":1,"i":0},{
"key":"A","x":2,"y":4,"s":1,"i":0},{
"key":"BJ","x":2,"y":5,"s":1,"i":0},{
"key":"A","x":2,"y":6,"s":1,"i":0},{
"key":"K","x":2,"y":7,"s":1,"i":0},{
"key":"A","x":2,"y":8,"s":1,"i":0},{
"key":"K","x":2,"y":9,"s":1,"i":0},{
"key":"K","x":2,"y":10,"s":1,"i":0},{
"key":"CJ","x":3,"y":0,"s":1,"i":0},{
"key":"K","x":3,"y":1,"s":1,"i":0},{
"key":"A","x":3,"y":2,"s":1,"i":0},{
"key":"K","x":3,"y":3,"s":1,"i":0},{
"key":"K","x":3,"y":4,"s":1,"i":0},{
"key":"K","x":3,"y":5,"s":1,"i":0},{
"key":"K","x":3,"y":6,"s":1,"i":0},{
"key":"A","x":3,"y":7,"s":1,"i":0},{
"key":"K","x":3,"y":8,"s":1,"i":0},{
"key":"CJ","x":3,"y":9,"s":1,"i":0},{
"key":"K","x":4,"y":0,"s":1,"i":0},{
"key":"K","x":4,"y":1,"s":1,"i":0},{
"key":"C","x":4,"y":2,"s":1,"i":0},{
"key":"C","x":4,"y":3,"s":1,"i":0},{
"key":"K","x":4,"y":4,"s":1,"i":0},{
"key":"C","x":4,"y":5,"s":1,"i":0},{
"key":"K","x":4,"y":6,"s":1,"i":0},{
"key":"C","x":4,"y":7,"s":1,"i":0},{
"key":"C","x":4,"y":8,"s":1,"i":0},{
"key":"K","x":4,"y":9,"s":1,"i":0},{
"key":"K","x":4,"y":10,"s":1,"i":0},{
"key":"B","x":5,"y":0,"s":1,"i":0},{
"key":"K","x":5,"y":1,"s":1,"i":0},{
"key":"K","x":5,"y":2,"s":1,"i":0},{
"key":"B","x":5,"y":3,"s":1,"i":0},{
"key":"B","x":5,"y":4,"s":1,"i":0},{
"key":"C","x":5,"y":5,"s":1,"i":0},{
"key":"C","x":5,"y":6,"s":1,"i":0},{
"key":"K","x":5,"y":7,"s":1,"i":0},{
"key":"K","x":5,"y":8,"s":1,"i":0},{
"key":"C","x":5,"y":9,"s":1,"i":0},{
"key":"B","x":6,"y":0,"s":1,"i":0},{
"key":"K","x":6,"y":1,"s":1,"i":0},{
"key":"B","x":6,"y":2,"s":1,"i":0},{
"key":"K","x":6,"y":3,"s":1,"i":0},{
"key":"C","x":6,"y":4,"s":1,"i":0},{
"key":"B","x":6,"y":5,"s":1,"i":0},{
"key":"A","x":6,"y":6,"s":1,"i":0},{
"key":"K","x":6,"y":7,"s":1,"i":0},{
"key":"C","x":6,"y":8,"s":1,"i":0},{
"key":"K","x":6,"y":9,"s":1,"i":0},{
"key":"C","x":6,"y":10,"s":1,"i":0},{
"key":"B","x":7,"y":0,"s":1,"i":0},{
"key":"B","x":7,"y":1,"s":1,"i":0},{
"key":"C","x":7,"y":2,"s":1,"i":0},{
"key":"A","x":7,"y":3,"s":1,"i":0},{
"key":"C","x":7,"y":4,"s":1,"i":0},{
"key":"B","x":7,"y":5,"s":1,"i":0},{
"key":"A","x":7,"y":6,"s":1,"i":0},{
"key":"B","x":7,"y":7,"s":1,"i":0},{
"key":"C","x":7,"y":8,"s":1,"i":0},{
"key":"C","x":7,"y":9,"s":1,"i":0},{
"key":"C","x":8,"y":0,"s":1,"i":0},{
"key":"C","x":8,"y":1,"s":1,"i":0},{
"key":"C","x":8,"y":2,"s":1,"i":0},{
"key":"A","x":8,"y":3,"s":1,"i":0},{
"key":"A","x":8,"y":4,"s":1,"i":0},{
"key":"C","x":8,"y":5,"s":1,"i":0},{
"key":"A","x":8,"y":6,"s":1,"i":0},{
"key":"A","x":8,"y":7,"s":1,"i":0},{
"key":"B","x":8,"y":8,"s":1,"i":0},{
"key":"B","x":8,"y":9,"s":1,"i":0},{
"key":"B","x":8,"y":10,"s":1,"i":0},{
"key":"B","x":9,"y":3,"s":1,"i":0},{
"key":"B","x":9,"y":4,"s":1,"i":0},{
"key":"C","x":9,"y":5,"s":1,"i":0},{
"key":"C","x":9,"y":6,"s":1,"i":0},{
"key":"C","x":10,"y":0,"s":1,"i":0},{
"key":"C","x":10,"y":1,"s":1,"i":0},{
"key":"C","x":10,"y":2,"s":1,"i":0},{
"key":"B","x":10,"y":3,"s":1,"i":0},{
"key":"A","x":10,"y":4,"s":1,"i":0},{
"key":"A","x":10,"y":5,"s":1,"i":0},{
"key":"A","x":10,"y":6,"s":1,"i":0},{
"key":"C","x":10,"y":7,"s":1,"i":0},{
"key":"B","x":10,"y":8,"s":1,"i":0},{
"key":"B","x":10,"y":9,"s":1,"i":0},{
"key":"B","x":10,"y":10,"s":1,"i":0},{
"key":"A","x":11,"y":0,"s":1,"i":0},{
"key":"A","x":11,"y":1,"s":1,"i":0},{
"key":"A","x":11,"y":2,"s":1,"i":0},{
"key":"A","x":11,"y":3,"s":1,"i":0},{
"key":"K","x":11,"y":4,"s":1,"i":0},{
"key":"K","x":11,"y":5,"s":1,"i":0},{
"key":"A","x":11,"y":6,"s":1,"i":0},{
"key":"A","x":11,"y":7,"s":1,"i":0},{
"key":"A","x":11,"y":8,"s":1,"i":0},{
"key":"A","x":11,"y":9,"s":1,"i":0},{
"key":"K","x":12,"y":0,"s":1,"i":0},{
"key":"K","x":12,"y":1,"s":1,"i":0},{
"key":"K","x":12,"y":2,"s":1,"i":0},{
"key":"K","x":12,"y":3,"s":1,"i":0},{
"key":"K","x":12,"y":4,"s":1,"i":0},{
"key":"K","x":12,"y":6,"s":1,"i":0},{
"key":"K","x":12,"y":7,"s":1,"i":0},{
"key":"K","x":12,"y":8,"s":1,"i":0},{
"key":"K","x":12,"y":9,"s":1,"i":0},{
"key":"K","x":12,"y":10,"s":1,"i":0}],"sub
":[],"down
":[],"jysub

":[]}