{
"BackCround":{
"backCround_type":1,"bottom_type":2,"skill_type":0},"level":126,"mode":1,"LevelType":{
"Key":"@","Type":1,"Number":5},"Star":{
"star1":120,"star2":7150,"star3":14200},"Gang":{
"Gang1":0,"Gang2":1,"Gang3":0,"Gang4":0,"Gang5":0},"ReadyBubble":{
"R1":2,"R2":1,"R3":0,"R4":0},"BallNumber":25,"TimeLimit":0,"ObjChance":[{
"Key":"C","P":3},{
"Key":"A","P":3},{
"Key":"B","P":3},{
"Key":"D","P":3}],"top":[],"bubble
":[{
"key":"D","x":0,"y":0,"s":1,"i":0},{
"key":"D","x":0,"y":1,"s":1,"i":0},{
"key":"@","x":0,"y":2,"s":1,"i":0},{
"key":"@","x":0,"y":3,"s":1,"i":0},{
"key":"AJ","x":0,"y":4,"s":1,"i":0},{
"key":"@","x":0,"y":5,"s":1,"i":0},{
"key":"@","x":0,"y":6,"s":1,"i":0},{
"key":"C","x":0,"y":7,"s":1,"i":0},{
"key":"@","x":0,"y":8,"s":1,"i":0},{
"key":"BJ","x":0,"y":9,"s":1,"i":0},{
"key":"@","x":0,"y":10,"s":1,"i":0},{
"key":"G","x":1,"y":0,"s":1,"i":0},{
"key":"G","x":1,"y":1,"s":1,"i":0},{
"key":"G","x":1,"y":2,"s":1,"i":0},{
"key":"G","x":1,"y":3,"s":1,"i":0},{
"key":"G","x":1,"y":4,"s":1,"i":0},{
"key":"G","x":1,"y":5,"s":1,"i":0},{
"key":"G","x":1,"y":6,"s":1,"i":0},{
"key":"G","x":1,"y":7,"s":1,"i":0},{
"key":"G","x":1,"y":8,"s":1,"i":0},{
"key":"G","x":1,"y":9,"s":1,"i":0},{
"key":"B","x":2,"y":0,"s":1,"i":0},{
"key":"B","x":2,"y":1,"s":1,"i":0},{
"key":"C","x":2,"y":2,"s":1,"i":0},{
"key":"C","x":2,"y":3,"s":1,"i":0},{
"key":"C","x":2,"y":4,"s":1,"i":0},{
"key":"A","x":2,"y":5,"s":1,"i":0},{
"key":"A","x":2,"y":6,"s":1,"i":0},{
"key":"A","x":2,"y":7,"s":1,"i":0},{
"key":"A","x":2,"y":8,"s":1,"i":0},{
"key":"D","x":2,"y":9,"s":1,"i":0},{
"key":"D","x":2,"y":10,"s":1,"i":0},{
"key":"G","x":3,"y":0,"s":1,"i":0},{
"key":"G","x":3,"y":1,"s":1,"i":0},{
"key":"G","x":3,"y":2,"s":1,"i":0},{
"key":"G","x":3,"y":3,"s":1,"i":0},{
"key":"G","x":3,"y":4,"s":1,"i":0},{
"key":"G","x":3,"y":5,"s":1,"i":0},{
"key":"G","x":3,"y":6,"s":1,"i":0},{
"key":"G","x":3,"y":7,"s":1,"i":0},{
"key":"G","x":3,"y":8,"s":1,"i":0},{
"key":"G","x":3,"y":9,"s":1,"i":0},{
"key":"G","x":4,"y":0,"s":1,"i":0},{
"key":"G","x":4,"y":1,"s":1,"i":0},{
"key":"G","x":4,"y":2,"s":1,"i":0},{
"key":"G","x":4,"y":3,"s":1,"i":0},{
"key":"G","x":4,"y":4,"s":1,"i":0},{
"key":"G","x":4,"y":5,"s":1,"i":0},{
"key":"G","x":4,"y":6,"s":1,"i":0},{
"key":"G","x":4,"y":7,"s":1,"i":0},{
"key":"G","x":4,"y":8,"s":1,"i":0},{
"key":"G","x":4,"y":9,"s":1,"i":0},{
"key":"G","x":4,"y":10,"s":1,"i":0},{
"key":"C","x":5,"y":0,"s":1,"i":0},{
"key":"@","x":5,"y":1,"s":1,"i":0},{
"key":"AJ","x":5,"y":2,"s":1,"i":0},{
"key":"@","x":5,"y":3,"s":1,"i":0},{
"key":"@","x":5,"y":4,"s":1,"i":0},{
"key":"A","x":5,"y":5,"s":1,"i":0},{
"key":"D","x":5,"y":6,"s":1,"i":0},{
"key":"@","x":5,"y":7,"s":1,"i":0},{
"key":"@","x":5,"y":8,"s":1,"i":0},{
"key":"B","x":5,"y":9,"s":1,"i":0},{
"key":"C","x":6,"y":0,"s":1,"i":0},{
"key":"A","x":6,"y":1,"s":1,"i":0},{
"key":"@","x":6,"y":2,"s":1,"i":0},{
"key":"@","x":6,"y":3,"s":1,"i":0},{
"key":"@","x":6,"y":4,"s":1,"i":0},{
"key":"A","x":6,"y":5,"s":1,"i":0},{
"key":"C","x":6,"y":6,"s":1,"i":0},{
"key":"CJ","x":6,"y":7,"s":1,"i":0},{
"key":"@","x":6,"y":8,"s":1,"i":0},{
"key":"@","x":6,"y":9,"s":1,"i":0},{
"key":"B","x":6,"y":10,"s":1,"i":0},{
"key":"G","x":7,"y":0,"s":1,"i":0},{
"key":"G","x":7,"y":1,"s":1,"i":0},{
"key":"G","x":7,"y":2,"s":1,"i":0},{
"key":"G","x":7,"y":3,"s":1,"i":0},{
"key":"G","x":7,"y":4,"s":1,"i":0},{
"key":"G","x":7,"y":5,"s":1,"i":0},{
"key":"G","x":7,"y":6,"s":1,"i":0},{
"key":"G","x":7,"y":7,"s":1,"i":0},{
"key":"G","x":7,"y":8,"s":1,"i":0},{
"key":"G","x":7,"y":9,"s":1,"i":0},{
"key":"G","x":8,"y":0,"s":1,"i":0},{
"key":"G","x":8,"y":1,"s":1,"i":0},{
"key":"G","x":8,"y":2,"s":1,"i":0},{
"key":"G","x":8,"y":3,"s":1,"i":0},{
"key":"G","x":8,"y":4,"s":1,"i":0},{
"key":"G","x":8,"y":5,"s":1,"i":0},{
"key":"G","x":8,"y":6,"s":1,"i":0},{
"key":"G","x":8,"y":7,"s":1,"i":0},{
"key":"G","x":8,"y":8,"s":1,"i":0},{
"key":"G","x":8,"y":9,"s":1,"i":0},{
"key":"G","x":8,"y":10,"s":1,"i":0},{
"key":"C","x":9,"y":0,"s":1,"i":0},{
"key":"@","x":9,"y":1,"s":1,"i":0},{
"key":"@","x":9,"y":2,"s":1,"i":0},{
"key":"A","x":9,"y":3,"s":1,"i":0},{
"key":"BJ","x":9,"y":4,"s":1,"i":0},{
"key":"A","x":9,"y":5,"s":1,"i":0},{
"key":"A","x":9,"y":6,"s":1,"i":0},{
"key":"@","x":9,"y":7,"s":1,"i":0},{
"key":"@","x":9,"y":8,"s":1,"i":0},{
"key":"B","x":9,"y":9,"s":1,"i":0},{
"key":"C","x":10,"y":0,"s":1,"i":0},{
"key":"@","x":10,"y":1,"s":1,"i":0},{
"key":"@","x":10,"y":2,"s":1,"i":0},{
"key":"@","x":10,"y":3,"s":1,"i":0},{
"key":"A","x":10,"y":4,"s":1,"i":0},{
"key":"B","x":10,"y":5,"s":1,"i":0},{
"key":"B","x":10,"y":6,"s":1,"i":0},{
"key":"@","x":10,"y":7,"s":1,"i":0},{
"key":"@","x":10,"y":8,"s":1,"i":0},{
"key":"@","x":10,"y":9,"s":1,"i":0},{
"key":"B","x":10,"y":10,"s":1,"i":0},{
"key":"G","x":11,"y":0,"s":1,"i":0},{
"key":"G","x":11,"y":1,"s":1,"i":0},{
"key":"G","x":11,"y":2,"s":1,"i":0},{
"key":"G","x":11,"y":3,"s":1,"i":0},{
"key":"G","x":11,"y":4,"s":1,"i":0},{
"key":"G","x":11,"y":5,"s":1,"i":0},{
"key":"G","x":11,"y":6,"s":1,"i":0},{
"key":"G","x":11,"y":7,"s":1,"i":0},{
"key":"G","x":11,"y":8,"s":1,"i":0},{
"key":"G","x":11,"y":9,"s":1,"i":0},{
"key":"G","x":12,"y":0,"s":1,"i":0},{
"key":"G","x":12,"y":1,"s":1,"i":0},{
"key":"G","x":12,"y":2,"s":1,"i":0},{
"key":"G","x":12,"y":3,"s":1,"i":0},{
"key":"G","x":12,"y":4,"s":1,"i":0},{
"key":"G","x":12,"y":5,"s":1,"i":0},{
"key":"G","x":12,"y":6,"s":1,"i":0},{
"key":"G","x":12,"y":7,"s":1,"i":0},{
"key":"G","x":12,"y":8,"s":1,"i":0},{
"key":"G","x":12,"y":9,"s":1,"i":0},{
"key":"G","x":12,"y":10,"s":1,"i":0}],"sub
":[],"down
":[],"jysub

":[]}