{
"BackCround":{
"backCround_type":1,"bottom_type":2,"skill_type":0},"level":453,"mode":1,"LevelType":{
"Key":"@","Type":1,"Number":6},"Star":{
"star1":120,"star2":40000,"star3":45000},"Gang":{
"Gang1":0,"Gang2":1,"Gang3":0,"Gang4":0,"Gang5":0},"BallNumber":26,"TimeLimit":0,"ObjChance":[{
"Key":"C","P":4},{
"Key":"A","P":4},{
"Key":"B","P":4},{
"Key":"E","P":4},{
"Key":"D","P":4}],"top":[],"bubble
":[{
"key":"H","x":0,"y":3,"s":1,"i":0},{
"key":"H","x":0,"y":7,"s":1,"i":0},{
"key":"H","x":1,"y":2,"s":1,"i":0},{
"key":"CJ","x":1,"y":3,"s":1,"i":0},{
"key":"CJ","x":1,"y":6,"s":1,"i":0},{
"key":"H","x":1,"y":7,"s":1,"i":0},{
"key":"E","x":2,"y":2,"s":1,"i":0},{
"key":"H","x":2,"y":3,"s":1,"i":0},{
"key":"C","x":2,"y":4,"s":1,"i":0},{
"key":"C","x":2,"y":6,"s":1,"i":0},{
"key":"H","x":2,"y":7,"s":1,"i":0},{
"key":"D","x":2,"y":8,"s":1,"i":0},{
"key":"E","x":3,"y":1,"s":1,"i":0},{
"key":"H","x":3,"y":3,"s":1,"i":0},{
"key":"C","x":3,"y":4,"s":1,"i":0},{
"key":"C","x":3,"y":5,"s":1,"i":0},{
"key":"H","x":3,"y":6,"s":1,"i":0},{
"key":"D","x":3,"y":8,"s":1,"i":0},{
"key":"E","x":4,"y":1,"s":1,"i":0},{
"key":"I","x":4,"y":3,"s":1,"i":0},{
"key":"BJ","x":4,"y":4,"s":1,"i":0},{
"key":"C","x":4,"y":5,"s":1,"i":0},{
"key":"AJ","x":4,"y":6,"s":1,"i":0},{
"key":"I","x":4,"y":7,"s":1,"i":0},{
"key":"D","x":4,"y":9,"s":1,"i":0},{
"key":"E","x":5,"y":0,"s":1,"i":0},{
"key":"I","x":5,"y":2,"s":1,"i":0},{
"key":"I","x":5,"y":3,"s":1,"i":0},{
"key":"B","x":5,"y":4,"s":1,"i":0},{
"key":"A","x":5,"y":5,"s":1,"i":0},{
"key":"I","x":5,"y":6,"s":1,"i":0},{
"key":"I","x":5,"y":7,"s":1,"i":0},{
"key":"D","x":5,"y":9,"s":1,"i":0},{
"key":"EJ","x":6,"y":0,"s":1,"i":0},{
"key":"I","x":6,"y":3,"s":1,"i":0},{
"key":"F","x":6,"y":4,"s":1,"i":0},{
"key":"C1","x":6,"y":5,"s":1,"i":0},{
"key":"F","x":6,"y":6,"s":1,"i":0},{
"key":"I","x":6,"y":7,"s":1,"i":0},{
"key":"DJ","x":6,"y":10,"s":1,"i":0},{
"key":"I","x":7,"y":2,"s":1,"i":0},{
"key":"C1","x":7,"y":3,"s":1,"i":0},{
"key":"F","x":7,"y":4,"s":1,"i":0},{
"key":"F","x":7,"y":5,"s":1,"i":0},{
"key":"D1","x":7,"y":6,"s":1,"i":0},{
"key":"I","x":7,"y":7,"s":1,"i":0},{
"key":"I","x":8,"y":2,"s":1,"i":0},{
"key":"E","x":8,"y":3,"s":1,"i":0},{
"key":"B1","x":8,"y":4,"s":1,"i":0},{
"key":"F","x":8,"y":5,"s":1,"i":0},{
"key":"C1","x":8,"y":6,"s":1,"i":0},{
"key":"C","x":8,"y":7,"s":1,"i":0},{
"key":"I","x":8,"y":8,"s":1,"i":0},{
"key":"A","x":9,"y":2,"s":1,"i":0},{
"key":"D","x":9,"y":3,"s":1,"i":0},{
"key":"C1","x":9,"y":4,"s":1,"i":0},{
"key":"B1","x":9,"y":5,"s":1,"i":0},{
"key":"D","x":9,"y":6,"s":1,"i":0},{
"key":"E","x":9,"y":7,"s":1,"i":0},{
"key":"A","x":10,"y":2,"s":1,"i":0},{
"key":"C","x":10,"y":3,"s":1,"i":0},{
"key":"B","x":10,"y":4,"s":1,"i":0},{
"key":"D1","x":10,"y":5,"s":1,"i":0},{
"key":"A","x":10,"y":6,"s":1,"i":0},{
"key":"C","x":10,"y":7,"s":1,"i":0},{
"key":"E","x":10,"y":8,"s":1,"i":0},{
"key":"C","x":11,"y":1,"s":1,"i":0},{
"key":"D","x":11,"y":2,"s":1,"i":0},{
"key":"B","x":11,"y":4,"s":1,"i":0},{
"key":"A","x":11,"y":5,"s":1,"i":0},{
"key":"B","x":11,"y":7,"s":1,"i":0},{
"key":"D","x":11,"y":8,"s":1,"i":0},{
"key":"C","x":12,"y":1,"s":1,"i":0},{
"key":"D","x":12,"y":2,"s":1,"i":0},{
"key":"D","x":12,"y":3,"s":1,"i":0},{
"key":"C","x":12,"y":5,"s":1,"i":0},{
"key":"B","x":12,"y":7,"s":1,"i":0},{
"key":"B","x":12,"y":8,"s":1,"i":0},{
"key":"D","x":12,"y":9,"s":1,"i":0},{
"key":"C","x":13,"y":0,"s":1,"i":0},{
"key":"E","x":13,"y":1,"s":1,"i":0},{
"key":"E","x":13,"y":2,"s":1,"i":0},{
"key":"C","x":13,"y":3,"s":1,"i":0},{
"key":"C","x":13,"y":6,"s":1,"i":0},{
"key":"E","x":13,"y":7,"s":1,"i":0},{
"key":"E","x":13,"y":8,"s":1,"i":0},{
"key":"D","x":13,"y":9,"s":1,"i":0},{
"key":"B","x":14,"y":0,"s":1,"i":0},{
"key":"E","x":14,"y":1,"s":1,"i":0},{
"key":"A","x":14,"y":3,"s":1,"i":0},{
"key":"C","x":14,"y":4,"s":1,"i":0},{
"key":"C","x":14,"y":6,"s":1,"i":0},{
"key":"B","x":14,"y":7,"s":1,"i":0},{
"key":"E","x":14,"y":9,"s":1,"i":0},{
"key":"C","x":14,"y":10,"s":1,"i":0},{
"key":"B","x":15,"y":0,"s":1,"i":0},{
"key":"I","x":15,"y":1,"s":1,"i":0},{
"key":"A","x":15,"y":3,"s":1,"i":0},{
"key":"E","x":15,"y":4,"s":1,"i":0},{
"key":"E","x":15,"y":5,"s":1,"i":0},{
"key":"B","x":15,"y":6,"s":1,"i":0},{
"key":"I","x":15,"y":8,"s":1,"i":0},{
"key":"C","x":15,"y":9,"s":1,"i":0},{
"key":"B","x":16,"y":0,"s":1,"i":0},{
"key":"I","x":16,"y":1,"s":1,"i":0},{
"key":"A","x":16,"y":2,"s":1,"i":0},{
"key":"D","x":16,"y":4,"s":1,"i":0},{
"key":"E","x":16,"y":5,"s":1,"i":0},{
"key":"A","x":16,"y":6,"s":1,"i":0},{
"key":"B","x":16,"y":8,"s":1,"i":0},{
"key":"I","x":16,"y":9,"s":1,"i":0},{
"key":"C","x":16,"y":10,"s":1,"i":0},{
"key":"D","x":17,"y":1,"s":1,"i":0},{
"key":"E","x":17,"y":2,"s":1,"i":0},{
"key":"D","x":17,"y":4,"s":1,"i":0},{
"key":"A","x":17,"y":5,"s":1,"i":0},{
"key":"C","x":17,"y":7,"s":1,"i":0},{
"key":"D","x":17,"y":8,"s":1,"i":0},{
"key":"D","x":18,"y":1,"s":1,"i":0},{
"key":"E","x":18,"y":2,"s":1,"i":0},{
"key":"E","x":18,"y":3,"s":1,"i":0},{
"key":"C1","x":18,"y":5,"s":1,"i":0},{
"key":"C","x":18,"y":7,"s":1,"i":0},{
"key":"B","x":18,"y":8,"s":1,"i":0},{
"key":"D","x":18,"y":9,"s":1,"i":0},{
"key":"D","x":19,"y":0,"s":1,"i":0},{
"key":"A","x":19,"y":1,"s":1,"i":0},{
"key":"C","x":19,"y":2,"s":1,"i":0},{
"key":"H","x":19,"y":3,"s":1,"i":0},{
"key":"A","x":19,"y":4,"s":1,"i":0},{
"key":"D","x":19,"y":5,"s":1,"i":0},{
"key":"H","x":19,"y":6,"s":1,"i":0},{
"key":"A","x":19,"y":7,"s":1,"i":0},{
"key":"B","x":19,"y":8,"s":1,"i":0},{
"key":"D","x":19,"y":9,"s":1,"i":0},{
"key":"D","x":20,"y":0,"s":1,"i":0},{
"key":"A","x":20,"y":1,"s":1,"i":0},{
"key":"C","x":20,"y":3,"s":1,"i":0},{
"key":"H","x":20,"y":4,"s":1,"i":0},{
"key":"H","x":20,"y":6,"s":1,"i":0},{
"key":"E","x":20,"y":7,"s":1,"i":0},{
"key":"A","x":20,"y":9,"s":1,"i":0},{
"key":"D","x":20,"y":10,"s":1,"i":0},{
"key":"D","x":21,"y":0,"s":1,"i":0},{
"key":"B","x":21,"y":1,"s":1,"i":0},{
"key":"E","x":21,"y":3,"s":1,"i":0},{
"key":"H","x":21,"y":4,"s":1,"i":0},{
"key":"H","x":21,"y":5,"s":1,"i":0},{
"key":"C","x":21,"y":6,"s":1,"i":0},{
"key":"E","x":21,"y":8,"s":1,"i":0},{
"key":"D","x":21,"y":9,"s":1,"i":0},{
"key":"D","x":22,"y":1,"s":1,"i":0},{
"key":"B","x":22,"y":2,"s":1,"i":0},{
"key":"E","x":22,"y":4,"s":1,"i":0},{
"key":"H","x":22,"y":5,"s":1,"i":0},{
"key":"B","x":22,"y":6,"s":1,"i":0},{
"key":"C","x":22,"y":8,"s":1,"i":0},{
"key":"D","x":22,"y":9,"s":1,"i":0},{
"key":"C","x":23,"y":1,"s":1,"i":0},{
"key":"C","x":23,"y":2,"s":1,"i":0},{
"key":"A","x":23,"y":4,"s":1,"i":0},{
"key":"A","x":23,"y":5,"s":1,"i":0},{
"key":"B","x":23,"y":7,"s":1,"i":0},{
"key":"D","x":23,"y":8,"s":1,"i":0},{
"key":"A","x":24,"y":5,"s":1,"i":0}],"sub
":[]}