{
"BackCround":{
"backCround_type":1,"bottom_type":2,"skill_type":0},"level":359,"mode":1,"LevelType":{
"Key":"@","Type":1,"Number":3},"Star":{
"star1":120,"star2":37000,"star3":39000},"Gang":{
"Gang1":0,"Gang2":1,"Gang3":0,"Gang4":0,"Gang5":0},"BallNumber":27,"TimeLimit":0,"ObjChance":[{
"Key":"C","P":5},{
"Key":"A","P":5},{
"Key":"B","P":5},{
"Key":"E","P":5},{
"Key":"D","P":5}],"top":[],"bubble
":[{
"key":"@","x":0,"y":0,"s":1,"i":0},{
"key":"B1","x":0,"y":1,"s":1,"i":0},{
"key":"B1","x":0,"y":2,"s":1,"i":0},{
"key":"B1","x":0,"y":3,"s":1,"i":0},{
"key":"@","x":0,"y":4,"s":1,"i":0},{
"key":"A","x":0,"y":5,"s":1,"i":0},{
"key":"A","x":0,"y":6,"s":1,"i":0},{
"key":"@","x":0,"y":7,"s":1,"i":0},{
"key":"DJ","x":0,"y":8,"s":1,"i":0},{
"key":"@","x":0,"y":9,"s":1,"i":0},{
"key":"@","x":0,"y":10,"s":1,"i":0},{
"key":"@","x":1,"y":0,"s":1,"i":0},{
"key":"@","x":1,"y":1,"s":1,"i":0},{
"key":"BJ","x":1,"y":2,"s":1,"i":0},{
"key":"@","x":1,"y":3,"s":1,"i":0},{
"key":"AJ","x":1,"y":4,"s":1,"i":0},{
"key":"@","x":1,"y":5,"s":1,"i":0},{
"key":"@","x":1,"y":6,"s":1,"i":0},{
"key":"D","x":1,"y":7,"s":1,"i":0},{
"key":"@","x":1,"y":8,"s":1,"i":0},{
"key":"@","x":1,"y":9,"s":1,"i":0},{
"key":"F","x":2,"y":0,"s":1,"i":0},{
"key":"C1","x":2,"y":1,"s":1,"i":0},{
"key":"C1","x":2,"y":2,"s":1,"i":0},{
"key":"F","x":2,"y":3,"s":1,"i":0},{
"key":"C1","x":2,"y":5,"s":1,"i":0},{
"key":"C1","x":2,"y":6,"s":1,"i":0},{
"key":"D","x":2,"y":7,"s":1,"i":0},{
"key":"F","x":2,"y":8,"s":1,"i":0},{
"key":"@","x":2,"y":9,"s":1,"i":0},{
"key":"C1","x":2,"y":10,"s":1,"i":0},{
"key":"F","x":3,"y":0,"s":1,"i":0},{
"key":"C1","x":3,"y":1,"s":1,"i":0},{
"key":"F","x":3,"y":2,"s":1,"i":0},{
"key":"@","x":3,"y":5,"s":1,"i":0},{
"key":"@","x":3,"y":6,"s":1,"i":0},{
"key":"F","x":3,"y":7,"s":1,"i":0},{
"key":"F","x":3,"y":8,"s":1,"i":0},{
"key":"@","x":3,"y":9,"s":1,"i":0},{
"key":"@","x":4,"y":0,"s":1,"i":0},{
"key":"F","x":4,"y":1,"s":1,"i":0},{
"key":"F","x":4,"y":2,"s":1,"i":0},{
"key":"@","x":4,"y":3,"s":1,"i":0},{
"key":"C1","x":4,"y":4,"s":1,"i":0},{
"key":"C1","x":4,"y":5,"s":1,"i":0},{
"key":"@","x":4,"y":6,"s":1,"i":0},{
"key":"F","x":4,"y":7,"s":1,"i":0},{
"key":"C1","x":4,"y":8,"s":1,"i":0},{
"key":"F","x":4,"y":9,"s":1,"i":0},{
"key":"@","x":4,"y":10,"s":1,"i":0},{
"key":"@","x":5,"y":0,"s":1,"i":0},{
"key":"F","x":5,"y":1,"s":1,"i":0},{
"key":"@","x":5,"y":3,"s":1,"i":0},{
"key":"@","x":5,"y":4,"s":1,"i":0},{
"key":"F","x":5,"y":6,"s":1,"i":0},{
"key":"C1","x":5,"y":7,"s":1,"i":0},{
"key":"C1","x":5,"y":8,"s":1,"i":0},{
"key":"F","x":5,"y":9,"s":1,"i":0},{
"key":"C1","x":6,"y":0,"s":1,"i":0},{
"key":"C1","x":6,"y":1,"s":1,"i":0},{
"key":"C1","x":6,"y":4,"s":1,"i":0},{
"key":"C1","x":6,"y":7,"s":1,"i":0},{
"key":"C1","x":6,"y":8,"s":1,"i":0},{
"key":"C1","x":6,"y":9,"s":1,"i":0},{
"key":"C1","x":6,"y":10,"s":1,"i":0},{
"key":"B","x":7,"y":0,"s":1,"i":0},{
"key":"@","x":7,"y":1,"s":1,"i":0},{
"key":"E","x":7,"y":2,"s":1,"i":0},{
"key":"C","x":7,"y":3,"s":1,"i":0},{
"key":"D","x":7,"y":4,"s":1,"i":0},{
"key":"@","x":7,"y":5,"s":1,"i":0},{
"key":"B","x":7,"y":6,"s":1,"i":0},{
"key":"@","x":7,"y":7,"s":1,"i":0},{
"key":"C","x":7,"y":8,"s":1,"i":0},{
"key":"E","x":7,"y":9,"s":1,"i":0},{
"key":"C1","x":8,"y":0,"s":1,"i":0},{
"key":"C1","x":8,"y":2,"s":1,"i":0},{
"key":"C1","x":8,"y":3,"s":1,"i":0},{
"key":"C1","x":8,"y":4,"s":1,"i":0},{
"key":"C1","x":8,"y":5,"s":1,"i":0},{
"key":"C1","x":8,"y":6,"s":1,"i":0},{
"key":"C1","x":8,"y":8,"s":1,"i":0},{
"key":"C1","x":8,"y":9,"s":1,"i":0},{
"key":"C1","x":8,"y":10,"s":1,"i":0},{
"key":"@","x":9,"y":2,"s":1,"i":0},{
"key":"@","x":9,"y":3,"s":1,"i":0},{
"key":"@","x":9,"y":4,"s":1,"i":0},{
"key":"@","x":9,"y":5,"s":1,"i":0},{
"key":"B","x":9,"y":8,"s":1,"i":0},{
"key":"E","x":9,"y":9,"s":1,"i":0},{
"key":"@","x":10,"y":3,"s":1,"i":0},{
"key":"B","x":10,"y":4,"s":1,"i":0},{
"key":"@","x":10,"y":5,"s":1,"i":0},{
"key":"@","x":10,"y":7,"s":1,"i":0},{
"key":"B","x":10,"y":8,"s":1,"i":0},{
"key":"E","x":10,"y":9,"s":1,"i":0},{
"key":"@","x":10,"y":10,"s":1,"i":0},{
"key":"@","x":11,"y":0,"s":1,"i":0},{
"key":"@","x":11,"y":1,"s":1,"i":0},{
"key":"@","x":11,"y":2,"s":1,"i":0},{
"key":"@","x":11,"y":3,"s":1,"i":0},{
"key":"B","x":11,"y":4,"s":1,"i":0},{
"key":"@","x":11,"y":7,"s":1,"i":0},{
"key":"E","x":11,"y":8,"s":1,"i":0},{
"key":"A","x":11,"y":9,"s":1,"i":0},{
"key":"@","x":12,"y":1,"s":1,"i":0},{
"key":"@","x":12,"y":2,"s":1,"i":0},{
"key":"@","x":12,"y":4,"s":1,"i":0},{
"key":"@","x":12,"y":6,"s":1,"i":0},{
"key":"@","x":12,"y":8,"s":1,"i":0},{
"key":"A","x":12,"y":9,"s":1,"i":0},{
"key":"@","x":12,"y":10,"s":1,"i":0},{
"key":"@","x":13,"y":1,"s":1,"i":0},{
"key":"@","x":13,"y":5,"s":1,"i":0},{
"key":"L","x":13,"y":6,"s":1,"i":0},{
"key":"A","x":13,"y":8,"s":1,"i":0},{
"key":"@","x":13,"y":9,"s":1,"i":0},{
"key":"@","x":14,"y":5,"s":1,"i":0},{
"key":"@","x":14,"y":6,"s":1,"i":0},{
"key":"@","x":14,"y":7,"s":1,"i":0},{
"key":"@","x":14,"y":9,"s":1,"i":0},{
"key":"@","x":14,"y":10,"s":1,"i":0},{
"key":"@","x":15,"y":0,"s":1,"i":0},{
"key":"@","x":15,"y":1,"s":1,"i":0},{
"key":"J","x":15,"y":2,"s":1,"i":0},{
"key":"B","x":15,"y":3,"s":1,"i":0},{
"key":"E","x":15,"y":4,"s":1,"i":0},{
"key":"E","x":15,"y":5,"s":1,"i":0},{
"key":"E","x":15,"y":6,"s":1,"i":0},{
"key":"@","x":15,"y":7,"s":1,"i":0},{
"key":"B","x":15,"y":9,"s":1,"i":0},{
"key":"@","x":16,"y":0,"s":1,"i":0},{
"key":"@","x":16,"y":1,"s":1,"i":0},{
"key":"D","x":16,"y":2,"s":1,"i":0},{
"key":"D","x":16,"y":3,"s":1,"i":0},{
"key":"B","x":16,"y":4,"s":1,"i":0},{
"key":"B","x":16,"y":10,"s":1,"i":0},{
"key":"@","x":17,"y":0,"s":1,"i":0},{
"key":"@","x":17,"y":1,"s":1,"i":0},{
"key":"@","x":17,"y":2,"s":1,"i":0},{
"key":"D","x":17,"y":3,"s":1,"i":0},{
"key":"@","x":17,"y":5,"s":1,"i":0},{
"key":"@","x":17,"y":6,"s":1,"i":0},{
"key":"@","x":17,"y":7,"s":1,"i":0},{
"key":"B","x":17,"y":8,"s":1,"i":0},{
"key":"B","x":17,"y":9,"s":1,"i":0},{
"key":"C","x":18,"y":0,"s":1,"i":0},{
"key":"C","x":18,"y":1,"s":1,"i":0},{
"key":"C","x":18,"y":2,"s":1,"i":0},{
"key":"A","x":18,"y":3,"s":1,"i":0},{
"key":"@","x":18,"y":6,"s":1,"i":0},{
"key":"@","x":18,"y":7,"s":1,"i":0},{
"key":"D","x":18,"y":8,"s":1,"i":0},{
"key":"B","x":18,"y":9,"s":1,"i":0},{
"key":"@","x":19,"y":0,"s":1,"i":0},{
"key":"@","x":19,"y":1,"s":1,"i":0},{
"key":"A","x":19,"y":2,"s":1,"i":0},{
"key":"A","x":19,"y":3,"s":1,"i":0},{
"key":"@","x":19,"y":4,"s":1,"i":0},{
"key":"B","x":19,"y":5,"s":1,"i":0},{
"key":"B","x":19,"y":6,"s":1,"i":0},{
"key":"D","x":19,"y":7,"s":1,"i":0},{
"key":"D","x":19,"y":8,"s":1,"i":0},{
"key":"D","x":20,"y":0,"s":1,"i":0},{
"key":"@","x":20,"y":1,"s":1,"i":0},{
"key":"@","x":20,"y":2,"s":1,"i":0},{
"key":"@","x":20,"y":4,"s":1,"i":0},{
"key":"B","x":20,"y":5,"s":1,"i":0},{
"key":"@","x":20,"y":7,"s":1,"i":0},{
"key":"D","x":20,"y":8,"s":1,"i":0},{
"key":"D","x":21,"y":0,"s":1,"i":0},{
"key":"@","x":21,"y":1,"s":1,"i":0},{
"key":"B","x":21,"y":4,"s":1,"i":0},{
"key":"C","x":21,"y":6,"s":1,"i":0},{
"key":"C","x":21,"y":7,"s":1,"i":0},{
"key":"@","x":22,"y":0,"s":1,"i":0},{
"key":"D","x":22,"y":1,"s":1,"i":0},{
"key":"E","x":22,"y":3,"s":1,"i":0},{
"key":"@","x":22,"y":6,"s":1,"i":0},{
"key":"A","x":22,"y":7,"s":1,"i":0},{
"key":"@","x":23,"y":0,"s":1,"i":0},{
"key":"E","x":23,"y":2,"s":1,"i":0},{
"key":"@","x":23,"y":3,"s":1,"i":0},{
"key":"@","x":23,"y":5,"s":1,"i":0},{
"key":"D","x":23,"y":6,"s":1,"i":0},{
"key":"A","x":23,"y":7,"s":1,"i":0},{
"key":"@","x":23,"y":9,"s":1,"i":0},{
"key":"@","x":24,"y":0,"s":1,"i":0},{
"key":"K","x":24,"y":1,"s":1,"i":0},{
"key":"@","x":24,"y":2,"s":1,"i":0},{
"key":"B","x":24,"y":3,"s":1,"i":0},{
"key":"B","x":24,"y":4,"s":1,"i":0},{
"key":"K","x":24,"y":5,"s":1,"i":0},{
"key":"@","x":24,"y":6,"s":1,"i":0},{
"key":"D","x":24,"y":7,"s":1,"i":0},{
"key":"A","x":24,"y":8,"s":1,"i":0},{
"key":"K","x":24,"y":9,"s":1,"i":0},{
"key":"@","x":24,"y":10,"s":1,"i":0}],"sub
":[]}