{
"BackCround":{
"backCround_type":1,"bottom_type":2,"skill_type":0},"level":436,"mode":1,"LevelType":{
"Key":"@","Type":1,"Number":4},"Star":{
"star1":120,"star2":37000,"star3":41555},"Gang":{
"Gang1":0,"Gang2":1,"Gang3":1,"Gang4":1,"Gang5":1},"ReadyBubble":{
"R1":0,"R2":0,"R3":0,"R4":0},"BallNumber":31,"TimeLimit":0,"ObjChance":[{
"Key":"C","P":4},{
"Key":"A","P":4},{
"Key":"B","P":4},{
"Key":"D","P":4}],"top":[],"bubble
":[{
"key":"I","x":0,"y":1,"s":1,"i":0},{
"key":"G","x":0,"y":2,"s":1,"i":0},{
"key":"G","x":0,"y":3,"s":1,"i":0},{
"key":"H","x":0,"y":4,"s":1,"i":0},{
"key":"H","x":0,"y":5,"s":1,"i":0},{
"key":"K","x":0,"y":6,"s":1,"i":0},{
"key":"I","x":0,"y":7,"s":1,"i":0},{
"key":"I","x":0,"y":8,"s":1,"i":0},{
"key":"I","x":0,"y":9,"s":1,"i":0},{
"key":"I","x":1,"y":1,"s":1,"i":0},{
"key":"CJ","x":1,"y":2,"s":1,"i":0},{
"key":"CJ","x":1,"y":3,"s":1,"i":0},{
"key":"@","x":1,"y":4,"s":1,"i":0},{
"key":"@","x":1,"y":5,"s":1,"i":0},{
"key":"BJ","x":1,"y":6,"s":1,"i":0},{
"key":"BJ","x":1,"y":7,"s":1,"i":0},{
"key":"G","x":1,"y":8,"s":1,"i":0},{
"key":"I","x":2,"y":2,"s":1,"i":0},{
"key":"F","x":2,"y":3,"s":1,"i":0},{
"key":"F","x":2,"y":4,"s":1,"i":0},{
"key":"F","x":2,"y":5,"s":1,"i":0},{
"key":"F","x":2,"y":6,"s":1,"i":0},{
"key":"F","x":2,"y":7,"s":1,"i":0},{
"key":"G","x":2,"y":8,"s":1,"i":0},{
"key":"K","x":3,"y":2,"s":1,"i":0},{
"key":"@","x":3,"y":3,"s":1,"i":0},{
"key":"A1","x":3,"y":4,"s":1,"i":0},{
"key":"A1","x":3,"y":5,"s":1,"i":0},{
"key":"@","x":3,"y":6,"s":1,"i":0},{
"key":"H","x":3,"y":7,"s":1,"i":0},{
"key":"H","x":4,"y":3,"s":1,"i":0},{
"key":"A1","x":4,"y":4,"s":1,"i":0},{
"key":"N","x":4,"y":5,"s":1,"i":0},{
"key":"A1","x":4,"y":6,"s":1,"i":0},{
"key":"H","x":4,"y":7,"s":1,"i":0},{
"key":"H","x":5,"y":3,"s":1,"i":0},{
"key":"A1","x":5,"y":4,"s":1,"i":0},{
"key":"A1","x":5,"y":5,"s":1,"i":0},{
"key":"K","x":5,"y":6,"s":1,"i":0},{
"key":"G","x":6,"y":4,"s":1,"i":0},{
"key":"@","x":6,"y":5,"s":1,"i":0},{
"key":"I","x":6,"y":6,"s":1,"i":0},{
"key":"G","x":7,"y":4,"s":1,"i":0},{
"key":"I","x":7,"y":5,"s":1,"i":0},{
"key":"I","x":8,"y":5,"s":1,"i":0},{
"key":"B1","x":10,"y":2,"s":1,"i":0},{
"key":"B1","x":10,"y":3,"s":1,"i":0},{
"key":"B1","x":10,"y":4,"s":1,"i":0},{
"key":"B1","x":10,"y":5,"s":1,"i":0},{
"key":"B1","x":10,"y":6,"s":1,"i":0},{
"key":"H","x":10,"y":7,"s":1,"i":0},{
"key":"B","x":10,"y":8,"s":1,"i":0},{
"key":"H","x":11,"y":1,"s":1,"i":0},{
"key":"C","x":11,"y":2,"s":1,"i":0},{
"key":"D","x":11,"y":3,"s":1,"i":0},{
"key":"A","x":11,"y":4,"s":1,"i":0},{
"key":"B","x":11,"y":5,"s":1,"i":0},{
"key":"A","x":11,"y":7,"s":1,"i":0},{
"key":"C","x":11,"y":8,"s":1,"i":0},{
"key":"C","x":12,"y":1,"s":1,"i":0},{
"key":"A","x":12,"y":3,"s":1,"i":0},{
"key":"B","x":12,"y":4,"s":1,"i":0},{
"key":"J","x":12,"y":5,"s":1,"i":0},{
"key":"C","x":12,"y":7,"s":1,"i":0},{
"key":"J","x":12,"y":8,"s":1,"i":0},{
"key":"A","x":12,"y":9,"s":1,"i":0},{
"key":"B","x":13,"y":0,"s":1,"i":0},{
"key":"J","x":13,"y":1,"s":1,"i":0},{
"key":"A","x":13,"y":3,"s":1,"i":0},{
"key":"C","x":13,"y":4,"s":1,"i":0},{
"key":"D","x":13,"y":6,"s":1,"i":0},{
"key":"B","x":13,"y":7,"s":1,"i":0},{
"key":"C","x":13,"y":8,"s":1,"i":0},{
"key":"B","x":13,"y":9,"s":1,"i":0},{
"key":"B","x":14,"y":0,"s":1,"i":0},{
"key":"D","x":14,"y":1,"s":1,"i":0},{
"key":"D","x":14,"y":2,"s":1,"i":0},{
"key":"C","x":14,"y":4,"s":1,"i":0},{
"key":"C","x":14,"y":6,"s":1,"i":0},{
"key":"A","x":14,"y":7,"s":1,"i":0},{
"key":"L","x":14,"y":8,"s":1,"i":0},{
"key":"D","x":14,"y":9,"s":1,"i":0},{
"key":"B","x":14,"y":10,"s":1,"i":0},{
"key":"C","x":15,"y":0,"s":1,"i":0},{
"key":"A","x":15,"y":1,"s":1,"i":0},{
"key":"A","x":15,"y":3,"s":1,"i":0},{
"key":"B","x":15,"y":4,"s":1,"i":0},{
"key":"B","x":15,"y":6,"s":1,"i":0},{
"key":"A","x":15,"y":7,"s":1,"i":0},{
"key":"D","x":15,"y":8,"s":1,"i":0},{
"key":"B","x":15,"y":9,"s":1,"i":0},{
"key":"C","x":16,"y":1,"s":1,"i":0},{
"key":"D","x":16,"y":3,"s":1,"i":0},{
"key":"C","x":16,"y":4,"s":1,"i":0},{
"key":"C","x":16,"y":5,"s":1,"i":0},{
"key":"D","x":16,"y":7,"s":1,"i":0},{
"key":"C","x":16,"y":8,"s":1,"i":0},{
"key":"C","x":16,"y":9,"s":1,"i":0},{
"key":"H","x":17,"y":1,"s":1,"i":0},{
"key":"D","x":17,"y":2,"s":1,"i":0},{
"key":"A","x":17,"y":3,"s":1,"i":0},{
"key":"A","x":17,"y":4,"s":1,"i":0},{
"key":"D","x":17,"y":5,"s":1,"i":0},{
"key":"B","x":17,"y":7,"s":1,"i":0},{
"key":"A","x":17,"y":8,"s":1,"i":0},{
"key":"D","x":18,"y":2,"s":1,"i":0},{
"key":"B","x":18,"y":3,"s":1,"i":0},{
"key":"B","x":18,"y":4,"s":1,"i":0},{
"key":"A","x":18,"y":5,"s":1,"i":0},{
"key":"B","x":18,"y":6,"s":1,"i":0},{
"key":"H","x":18,"y":7,"s":1,"i":0},{
"key":"A","x":18,"y":8,"s":1,"i":0},{
"key":"J","x":20,"y":5,"s":1,"i":0},{
"key":"C","x":21,"y":4,"s":1,"i":0},{
"key":"C","x":21,"y":5,"s":1,"i":0},{
"key":"F","x":22,"y":6,"s":1,"i":0},{
"key":"B","x":23,"y":3,"s":1,"i":0},{
"key":"A","x":23,"y":4,"s":1,"i":0},{
"key":"J","x":23,"y":5,"s":1,"i":0},{
"key":"F","x":23,"y":6,"s":1,"i":0},{
"key":"D","x":24,"y":3,"s":1,"i":0},{
"key":"A","x":24,"y":4,"s":1,"i":0},{
"key":"D","x":24,"y":5,"s":1,"i":0},{
"key":"F","x":24,"y":6,"s":1,"i":0},{
"key":"B","x":24,"y":7,"s":1,"i":0},{
"key":"B","x":26,"y":2,"s":1,"i":0},{
"key":"B","x":26,"y":3,"s":1,"i":0},{
"key":"D","x":26,"y":4,"s":1,"i":0},{
"key":"J","x":26,"y":5,"s":1,"i":0},{
"key":"A","x":26,"y":6,"s":1,"i":0},{
"key":"C","x":26,"y":7,"s":1,"i":0},{
"key":"B","x":26,"y":8,"s":1,"i":0},{
"key":"F","x":27,"y":1,"s":1,"i":0},{
"key":"F","x":27,"y":2,"s":1,"i":0},{
"key":"F","x":27,"y":3,"s":1,"i":0},{
"key":"F","x":27,"y":4,"s":1,"i":0},{
"key":"F","x":27,"y":5,"s":1,"i":0},{
"key":"F","x":27,"y":6,"s":1,"i":0},{
"key":"F","x":27,"y":7,"s":1,"i":0},{
"key":"F","x":27,"y":8,"s":1,"i":0},{
"key":"A","x":28,"y":2,"s":1,"i":0},{
"key":"D","x":28,"y":3,"s":1,"i":0},{
"key":"D","x":28,"y":4,"s":1,"i":0},{
"key":"B","x":28,"y":5,"s":1,"i":0},{
"key":"A","x":28,"y":6,"s":1,"i":0},{
"key":"C","x":28,"y":7,"s":1,"i":0},{
"key":"B","x":28,"y":8,"s":1,"i":0},{
"key":"F","x":29,"y":3,"s":1,"i":0},{
"key":"F","x":30,"y":3,"s":1,"i":0},{
"key":"J","x":30,"y":4,"s":1,"i":0},{
"key":"B","x":30,"y":5,"s":1,"i":0},{
"key":"C","x":30,"y":6,"s":1,"i":0},{
"key":"A","x":30,"y":7,"s":1,"i":0},{
"key":"F","x":31,"y":3,"s":1,"i":0},{
"key":"F","x":31,"y":4,"s":1,"i":0},{
"key":"F","x":31,"y":5,"s":1,"i":0},{
"key":"B","x":31,"y":6,"s":1,"i":0},{
"key":"B","x":33,"y":4,"s":1,"i":0},{
"key":"B","x":33,"y":5,"s":1,"i":0},{
"key":"J","x":34,"y":5,"s":1,"i":0}],"sub
":[{
"key":"S","x":10,"y":8,"s":0,"i":0},{
"key":"S","x":11,"y":7,"s":0,"i":0},{
"key":"S","x":11,"y":8,"s":0,"i":0},{
"key":"S","x":12,"y":7,"s":0,"i":0},{
"key":"S","x":12,"y":9,"s":0,"i":0},{
"key":"S","x":13,"y":6,"s":0,"i":0},{
"key":"S","x":13,"y":7,"s":0,"i":0},{
"key":"S","x":13,"y":8,"s":0,"i":0},{
"key":"S","x":13,"y":9,"s":0,"i":0},{
"key":"S","x":14,"y":4,"s":0,"i":0},{
"key":"S","x":14,"y":6,"s":0,"i":0},{
"key":"S","x":14,"y":10,"s":0,"i":0},{
"key":"S","x":15,"y":3,"s":0,"i":0},{
"key":"S","x":15,"y":4,"s":0,"i":0},{
"key":"S","x":15,"y":6,"s":0,"i":0},{
"key":"S","x":15,"y":7,"s":0,"i":0},{
"key":"S","x":15,"y":8,"s":0,"i":0},{
"key":"S","x":15,"y":9,"s":0,"i":0},{
"key":"S","x":16,"y":3,"s":0,"i":0},{
"key":"S","x":16,"y":5,"s":0,"i":0},{
"key":"S","x":16,"y":7,"s":0,"i":0},{
"key":"S","x":16,"y":9,"s":0,"i":0},{
"key":"S","x":17,"y":2,"s":0,"i":0},{
"key":"S","x":17,"y":5,"s":0,"i":0},{
"key":"S","x":17,"y":7,"s":0,"i":0},{
"key":"S","x":17,"y":8,"s":0,"i":0},{
"key":"S","x":18,"y":2,"s":0,"i":0},{
"key":"S","x":18,"y":3,"s":0,"i":0},{
"key":"S","x":18,"y":4,"s":0,"i":0},{
"key":"S","x":18,"y":5,"s":0,"i":0},{
"key":"S","x":18,"y":6,"s":0,"i":0},{
"key":"S","x":18,"y":8,"s":0,"i":0}]}