{
"BackCround":{
"backCround_type":1,"bottom_type":2,"skill_type":0},"level":2,"mode":1,"LevelType":{
"Key":"@","Type":1,"Number":7},"Star":{
"star1":120,"star2":2100,"star3":6100},"Gang":{
"Gang1":0,"Gang2":0,"Gang3":1,"Gang4":0,"Gang5":0},"ReadyBubble":{
"R1":1,"R2":3,"R3":2,"R4":0},"BallNumber":45,"TimeLimit":0,"ObjChance":[{
"Key":"C","P":1},{
"Key":"A","P":1},{
"Key":"B","P":1}],"top":[],"bubble
":[{
"key":"C","x":0,"y":1,"s":1,"i":0},{
"key":"C","x":0,"y":2,"s":1,"i":0},{
"key":"AJ","x":0,"y":5,"s":1,"i":0},{
"key":"B","x":0,"y":8,"s":1,"i":0},{
"key":"B","x":0,"y":9,"s":1,"i":0},{
"key":"C","x":1,"y":0,"s":1,"i":0},{
"key":"CJ","x":1,"y":1,"s":1,"i":0},{
"key":"C","x":1,"y":2,"s":1,"i":0},{
"key":"A","x":1,"y":4,"s":1,"i":0},{
"key":"A","x":1,"y":5,"s":1,"i":0},{
"key":"B","x":1,"y":7,"s":1,"i":0},{
"key":"BJ","x":1,"y":8,"s":1,"i":0},{
"key":"B","x":1,"y":9,"s":1,"i":0},{
"key":"C","x":2,"y":1,"s":1,"i":0},{
"key":"C","x":2,"y":2,"s":1,"i":0},{
"key":"A","x":2,"y":4,"s":1,"i":0},{
"key":"A","x":2,"y":5,"s":1,"i":0},{
"key":"A","x":2,"y":6,"s":1,"i":0},{
"key":"B","x":2,"y":8,"s":1,"i":0},{
"key":"B","x":2,"y":9,"s":1,"i":0},{
"key":"B","x":3,"y":0,"s":1,"i":0},{
"key":"B","x":3,"y":1,"s":1,"i":0},{
"key":"B","x":3,"y":2,"s":1,"i":0},{
"key":"B","x":3,"y":3,"s":1,"i":0},{
"key":"A","x":3,"y":4,"s":1,"i":0},{
"key":"A","x":3,"y":5,"s":1,"i":0},{
"key":"C","x":3,"y":6,"s":1,"i":0},{
"key":"C","x":3,"y":7,"s":1,"i":0},{
"key":"C","x":3,"y":8,"s":1,"i":0},{
"key":"C","x":3,"y":9,"s":1,"i":0},{
"key":"B","x":4,"y":1,"s":1,"i":0},{
"key":"A","x":4,"y":3,"s":1,"i":0},{
"key":"A","x":4,"y":4,"s":1,"i":0},{
"key":"B","x":4,"y":6,"s":1,"i":0},{
"key":"B","x":4,"y":7,"s":1,"i":0},{
"key":"C","x":4,"y":9,"s":1,"i":0},{
"key":"B","x":5,"y":1,"s":1,"i":0},{
"key":"A","x":5,"y":2,"s":1,"i":0},{
"key":"AJ","x":5,"y":3,"s":1,"i":0},{
"key":"A","x":5,"y":4,"s":1,"i":0},{
"key":"B","x":5,"y":5,"s":1,"i":0},{
"key":"BJ","x":5,"y":6,"s":1,"i":0},{
"key":"B","x":5,"y":7,"s":1,"i":0},{
"key":"C","x":5,"y":8,"s":1,"i":0},{
"key":"B","x":6,"y":2,"s":1,"i":0},{
"key":"A","x":6,"y":3,"s":1,"i":0},{
"key":"A","x":6,"y":4,"s":1,"i":0},{
"key":"B","x":6,"y":6,"s":1,"i":0},{
"key":"B","x":6,"y":7,"s":1,"i":0},{
"key":"C","x":6,"y":8,"s":1,"i":0},{
"key":"B","x":7,"y":1,"s":1,"i":0},{
"key":"C","x":7,"y":4,"s":1,"i":0},{
"key":"C","x":7,"y":5,"s":1,"i":0},{
"key":"C","x":7,"y":8,"s":1,"i":0},{
"key":"B","x":8,"y":1,"s":1,"i":0},{
"key":"C","x":8,"y":4,"s":1,"i":0},{
"key":"CJ","x":8,"y":5,"s":1,"i":0},{
"key":"C","x":8,"y":6,"s":1,"i":0},{
"key":"C","x":8,"y":9,"s":1,"i":0},{
"key":"B","x":9,"y":0,"s":1,"i":0},{
"key":"A","x":9,"y":1,"s":1,"i":0},{
"key":"A","x":9,"y":2,"s":1,"i":0},{
"key":"A","x":9,"y":3,"s":1,"i":0},{
"key":"C","x":9,"y":4,"s":1,"i":0},{
"key":"C","x":9,"y":5,"s":1,"i":0},{
"key":"A","x":9,"y":6,"s":1,"i":0},{
"key":"A","x":9,"y":7,"s":1,"i":0},{
"key":"A","x":9,"y":8,"s":1,"i":0},{
"key":"C","x":9,"y":9,"s":1,"i":0},{
"key":"A","x":10,"y":4,"s":1,"i":0},{
"key":"AJ","x":10,"y":5,"s":1,"i":0},{
"key":"A","x":10,"y":6,"s":1,"i":0},{
"key":"A","x":11,"y":4,"s":1,"i":0},{
"key":"A","x":11,"y":5,"s":1,"i":0},{
"key":"A","x":12,"y":5,"s":1,"i":0}],"sub
":[],"down
":[]}